COMM	Comment
PCNT	Tag-Playcount
POPM	Tag-Rating
RVAD	Tag-Volume
TALB	Album
TBPM	BPM
TCOM	Composer
TCON	Genre
TDAT	Date
TIT1	Contentgroup
TIT2	Title
TIT3	Subtitle
TLAN	Language
TLEN	Tag-Length
TPE1	Artist
TPE2	Artist2
TPE3	Artist3
TPE4	ModifiedBy
TPUB	Publisher
TRCK	TrackNr
TRDA	Recording date
TXXX	User defined
USER	License
WCOP	Copyright